1,1,1,1,1,1,1,1,1,1,1,1,1,1,1
1,0,0,0,0,0,0,0,1,1,1,1,1,1,1
1,0,3,0,0,0,0,0,1,1,1,1,1,1,1
1,0,0,0,0,5,0,0,0,1,1,1,1,1,1
1,0,0,0,0,0,0,0,0,0,1,1,1,1,1
1,0,0,0,1,1,0,0,0,0,0,0,1,1,1
1,5,0,1,1,1,0,0,0,9,0,0,0,1,1
1,0,0,1,1,1,0,0,0,0,0,0,0,0,1
1,0,0,1,1,1,0,0,0,0,0,0,0,0,1
1,0,0,1,1,1,0,0,0,1,1,0,0,0,1
1,0,5,1,1,1,5,0,1,1,1,1,0,0,1
1,0,0,1,1,1,0,0,1,1,1,1,0,5,1
1,0,0,1,1,1,0,0,0,1,1,0,0,0,1
1,5,0,0,1,1,0,0,0,0,0,0,0,0,1
1,0,0,0,0,0,0,0,0,0,0,0,0,0,1
1,0,0,0,0,0,0,0,0,0,9,0,0,0,1
1,0,0,0,0,0,1,1,0,0,0,0,0,0,1
1,0,0,5,0,0,1,1,1,0,0,0,0,0,1
1,1,0,0,0,1,1,1,1,1,7,0,0,0,1
1,1,1,0,0,1,1,1,1,1,0,0,0,0,1
1,1,1,1,1,1,1,1,1,1,0,0,0,0,1
1,1,1,1,1,1,1,1,1,0,0,0,0,7,1
1,1,1,1,1,1,1,1,0,0,0,0,0,1,1
1,1,0,0,1,1,1,0,0,0,0,0,1,1,1
1,0,0,0,0,0,0,0,0,0,0,1,1,1,1
1,0,0,9,0,0,0,5,0,0,1,1,1,1,1
1,0,0,0,0,0,0,0,0,1,1,1,1,1,1
1,0,0,0,1,0,0,0,0,0,1,1,1,1,1
1,0,0,1,1,1,0,0,0,0,0,1,1,1,1
1,0,0,1,1,1,0,0,5,0,0,1,1,1,1
1,0,0,0,1,0,0,0,0,0,1,1,1,1,1
1,0,0,7,0,0,0,0,1,1,1,1,1,1,1
1,0,0,0,0,0,1,1,1,1,1,1,1,1,1
1,1,0,0,0,1,1,1,1,1,1,1,1,1,1
1,1,0,0,0,1,1,1,1,1,1,1,1,1,1
1,1,0,0,0,0,1,1,1,1,0,0,0,0,1
1,1,0,0,0,0,0,0,0,0,0,0,0,0,1
1,1,1,0,0,0,7,0,0,0,0,0,4,0,1
1,1,1,1,0,0,0,0,0,0,0,0,0,0,1
1,1,1,1,1,1,1,1,1,1,1,1,1,1,1,1,1,1,1,1,1,1,1,1,1,1,1,1,1,1,1,1,1,1,1,1,1,1,1,1,1