1,1,1,1,1,1,1,1,1,1,1,1,1,1,1,1,1,1,1,1,1,1,1,1,1
1,2,0,0,0,1,1,1,0,0,0,1,1,1,1,0,0,0,0,0,0,0,0,0,1
1,0,0,0,0,1,1,1,0,0,0,1,1,1,1,0,0,0,0,0,0,0,11,0,1
1,0,0,0,0,1,1,1,0,6,0,1,1,1,1,0,0,0,0,0,11,0,0,0,1
1,0,0,0,0,1,1,1,0,5,0,1,1,1,1,0,5,0,0,0,0,0,0,0,1
1,0,5,0,0,1,1,1,0,0,0,1,1,1,1,0,10,0,0,0,3,11,0,0,1
1,0,0,0,0,1,1,1,0,9,0,1,1,1,1,0,0,0,0,0,0,0,0,0,1
1,7,0,0,0,1,1,1,0,0,0,1,1,1,1,0,5,0,0,0,0,0,0,0,1
1,0,8,0,0,0,0,0,0,0,0,0,0,0,0,0,0,0,0,0,0,0,0,0,1
1,0,0,0,0,0,0,0,6,0,0,0,0,0,0,0,0,10,0,0,0,0,0,0,1
1,0,0,0,0,0,0,0,0,0,0,0,0,0,0,0,0,0,0,0,0,0,0,0,1
1,0,0,0,0,0,1,1,1,1,1,1,1,1,1,1,1,1,1,0,0,0,0,0,1
1,0,0,0,7,0,0,0,1,1,1,1,1,1,1,1,1,1,1,0,0,0,0,7,1
1,0,0,0,0,0,8,0,0,0,0,0,0,1,1,1,1,1,1,0,0,0,4,0,1
1,0,0,0,0,0,0,0,0,0,0,6,0,0,0,0,0,0,0,0,0,0,0,0,1
1,1,1,1,1,1,1,1,1,1,1,1,1,1,1,1,1,1,1,1,1,1,1,1,1
