1,2,2,2,2,2,2,2,2,2,2,2,2,1,1,1,1,1,1,1
1,0,0,0,0,0,0,0,0,0,0,0,0,1,1,1,1,1,1,1
1,0,0,0,0,1,1,1,1,1,0,0,0,2,1,1,1,1,1,1
1,0,0,4,0,2,2,2,1,1,0,0,5,0,2,2,2,1,1,1
1,1,9,0,0,0,0,0,1,1,1,0,0,3,0,0,0,2,1,1
1,1,0,6,0,0,0,0,1,1,1,1,0,0,1,0,0,0,2,1
1,1,0,0,0,0,0,0,1,1,1,1,1,1,1,0,5,0,0,1
1,2,0,1,0,2,2,2,2,1,1,1,1,1,1,0,0,0,0,1
1,0,0,1,0,0,0,0,0,2,2,1,1,1,1,0,0,0,2,1
1,0,8,2,1,1,1,0,0,0,0,2,2,2,2,2,0,0,0,1
1,0,0,0,1,1,1,0,0,1,0,0,0,0,0,0,0,0,0,1
1,0,0,1,1,1,1,0,0,1,0,1,1,1,1,0,0,0,0,1
1,0,1,1,1,1,1,0,0,2,0,1,1,1,1,1,1,0,0,1
1,0,2,2,2,2,1,1,0,0,0,1,1,1,1,1,1,0,0,1
1,0,0,0,0,0,1,1,1,0,0,1,1,1,1,1,1,0,0,1
1,0,0,0,0,0,1,1,1,0,0,2,2,2,2,2,2,0,0,1
1,0,0,0,0,0,1,1,1,0,0,0,0,0,0,0,0,0,0,1
1,0,7,0,0,0,1,1,1,0,0,1,1,0,0,0,0,0,0,1
1,0,0,0,0,0,1,1,1,1,1,1,1,0,0,0,0,0,0,1
1,1,1,1,1,1,1,1,1,1,1,1,1,1,1,1,1,1,1,1